....x.....
....x.....
....x.....
....xxx...
..........
..........
..........
..........
..........
..........
..........